WWWWWWWWWWWWWWWWWWWWWWWWWWWWWWWWWWWWWWWWWW
WWWWNWWWWWWWWWWWWWWWWWWWWWWWWWWWWWWWWWWWWW
WWWWPWWWWWWWWWWWWWWWWWWWWWWWWWWWWWWWWWWWWW
WWWWPWWWWWWWWWWWWWWWWWWWWWWWWWWWWWWWWWWWWW
WWWWPWWWWWWWWWWWWWWWWWWWWWWWWWWWWWWWWWWWWW
WWWWPWWWWWWWWWWWWWWWWWWWWWWWWWWWWWWWWWWWWW
WWWWPWWWWWWWWWWWWWWWWWWWWWWWWWWWWWWWWWWWWW
WWWWPWWWWWWWWWWWWWWWWWWWWWWWWWWWWWWWWWWWWW
WWWWPWWWWWWWWWWWWWWWWWWWWWWWWWWWWWWWWWWWWW
WWWWPWWWWWWWWWWWWWWWWWWWWWWWWWWWWWWWWWWWWW
WWWWPWWWWWWWWWWWWWWWWWWWWWWWWWWWWWWWWWWWWW
WWWWPWWWWWWWWWWWWWWWWWWWWWWWWWWWWWWWWWWWWW
WWWWPWWWWWWWWWWWWWWWWWWWWWWWWWWWWWWWWWWWWW
WWWWPWWWWWWWWWWWWWWWWWWWWWWWWWWWWWWWWWWWWW
WWWWPWWWWWWWWWWWWWWWWWWWWWWWWWWWWWWWWWWWWW
WWWWPWWWWWWWWWWWWWWWWWWWWWWWWWWWWWWWWWWWWW
WWWWPWWWWWWWWWWWWWWWWWWWWWWWWWWWWWWWWWWWWW
WWWWPWWWWWWWWWWWWWWWWWWWWWWWWWWWWWWWWWWWWW
WWWWPWWWWWWWWWWWWWWWWWWWWWWWWWWWWWWWWWWWWW
WWWWPWWWWNPPNWWWWWWWWWWWWWWWWWWWWWWWWWWWWW
WWWWPWWWWPWWWWWWWWWWWWWWWWWWWWWWWWWWWWWWWW
WWWWPWWWWPWWWWWWWWWWWWWWWWWWWWWWWWWWWWWWWW
WWWWPWWWWPWWWWWWWWWWWWWWWWWWWWWWWWWWWWWWWW
WWWWPWWWWPWWWWWWWWWWWWWWWWWWWWWWWWWWWWWWWW
WWWWPWWWWPWWWWWWWWWWWWWWWWWWWWWWWWWWWWWWWW
WWWWPWWWWPWWWWWWWWWWWWWWWWWWWWWWWWWWWWWWWW
WWWWPWWWWPWWWWWWWWWWWWWWWWWWWWWWWWWWWWWWWW
WWWWPWWWWPWWWWNPPPPPPPPPPPPPPPPPPPPPPNPPNW
WWWWPWWWWPWWWWPWWWWWWWWWWWWWWWWWWWWWWPWWPW
WWWWPWWWWPWWWWPWWWWWWWWWWWWWWWWWWWWWWPWWPW
WNPPNPPPPNPPPPNPPPPPPPPPPPPPPPPPPPPPPNWWPW
WPWWWWWWWWWWWWPWWWWWWWWWWWWWWWWWWWWWWPWWPW
WPWWWWWWWWWWWWPWWWWWWWWWWWWWWWWWWWWWWPWWPW
WPWWWWWWWWWWWWPWWWWWWWWWWWWWWWWWWWWWWPWWPW
WPWWWWWWWWWWWWPWWWWWWWWWWWWWWWWWWWWWWPWWPW
WPWWWWWWWWWWWWPWWWWWWWWWWWWWWWWWWWWWWPWWPW
WPWWWWWWWWWWWWPWWWWWWWWWWWWWWWWWWWWWWPWWPW
WPWWWWWWWWWWWWNPPNPPPPPPNPPPPPNPPNWWWPWWPW
WPWWWWWWWWWWWWPWWPWWWWWWWWWWWWPWWPWWWPWWPW
WPWWWWWWWWWWWWPWWPWWWWNPPPPPNWPWWPWWWPWWPW
WPWNPPPPPPPPPPNWWPWWWWPWWWWWPWPWWPWWWPWWPW
WPWWWWWWWWWWWWWWWPWWWWPWWWWWPWPWWPWWWPWWPW
WPWWWWWWWWWWWWWWWPWWWWPWWWWWPWPWWPWWWPWWPW
WPWWWWWWWWWWWWWWWNWWWWPWWWWWPWPWWPWWWNPPNW
WPWWWWWWWWWWWWWWWWWWWWPWWWWWPWPWWPWWWPWWWW
WPWWWWWWWWWWWWWWWWWWWWPWWWWWNPNWWPWWWPWWWW
WPWWWWWWWWWWWWWWWWWWWWPWWWWWPWWWWPWWWPWWWW
WPWWWWWWWWWWWWWWWWWWWWPWWWWWPWWWWPWWWPWWWW
WNPPPPPPPPPPPPPPPPPNPPNPPNPPNPPPPNPPPNWWWW
WWWWWWWWWWWWWWWWWWWPWWWWWWWWWWWWWWWWWWWWWW
WWWWWWWWWWWWWWWWWWWPWWWWWWWWWWWWWWWWWWWWWW
WWWWWWWWWWWWWWWWWWWPWWWWWWWWWWWWWWWWWWWWWW
WWWWWWWWWWWWWWWWWWWPWWNWWWWWWWWWWWWWWWWWWW
WWWWWWWWWWWWWWWWWWWPWWPWWWWWWWWWWWWWWWWWWW
WWWWWWWWWWWWWWWWWWWPWWPWWWWWWWWWWWWWWWWWWW
WWWWWWWWWWWWWWWWWWWPWWPWWWWWWWWWWWWWWWWWWW
WWWWWWWWWWWWWWWWWWWPWWPWWWWWWWWWWWWWWWWWWW
WWWWWWWWWWWWWWWWWWWPWWPWWWWWWWWWWWWWWWWWWW
WWWWWWWWWWWWWWWWWWWPWWPWWWWWWWWWWWWWWWWWWW
WWWWWWWWWWWWWWWWWWWNPPNWWWWWWWWWWWWWWWWWWW
WWWWWWWWWWWWWWWWWWWWWWWWWWWWWWWWWWWWWWWWWW